size=20
name = TEST
playerSpawn=2x2






x001'x001'x001'x001'x001'x001'x001'x001'x001'x001'x001'x001'x001'x001'x001'x001'x001'x001'x001'x001'
x001'g000'e000'e000'e000'e000'e000'e000'e000'e000'e000'e000'e000'e000'e000'e000'e000'e000'e000'x001'
x001'g010'e000'e000'e000'e000'e000'e000'e000'e000'e000'e000'e000'e000'e000'e000'e000'e000'e000'x001'
x001'g020'e000'e000'e000'e000'e000'e000'e000'e000'e000'e000'e000'e000'e000'e000'e000'e000'e000'x001'
x001'g030'e000'e000'e000'd101'e000'e000'e000'e000'e000'e000'e000'e000'e000'e000'e000'e000'e000'x001'
x001'g040'e000'e000'e000'e000'e000'e000'e000'e000'e000'e000'e000'e000'e000'e000'e000'e000'e000'x001'
x001'g050'e000'e000'e000'e000'e000'e000'e000'e000'e000'e000'e000'e000'e000'e000'e000'e000'e000'x001'
x001'g060'e000'e000'e000'e000'e000'e000'e000'e000'e000'e000'e000'e000'e000'e000'e000'e000'e000'x001'
x001'g070'e000'e000'e000'e000'e000'e000'e000'e000'e000'e000'e000'e000'e000'e000'e000'e000'e000'x001'
x001'g080'e000'e000'e000'e000'e000'e000'e000'e000'e000'e000'e000'e000'e000'e000'e000'e000'e000'x001'
x001'g000'e000'e000'e000'e000'e000'e000'e000'e000'e000'e000'e000'e000'e000'e000'e000'e000'e000'x001'
x001'g000'e000'e000'e000'e000'e000'e000'e000'e000'e000'e000'e000'e000'e000'e000'e000'e000'e000'x001'
x001'g000'e000'e000'e000'e000'e000'e000'e000'e000'e000'e000'e000'e000'e000'e000'e000'e000'e000'x001'
x001'g000'e000'e000'e000'e000'e000'e000'e000'e000'e000'e000'e000'e000'e000'e000'e000'e000'e000'x001'
x001'g000'e000'e000'e000'e000'e000'e000'e000'e000'e000'e000'e000'e000'e000'e000'e000'e000'e000'x001'
x001'g000'e000'e000'e000'e000'e000'e000'e000'e000'e000'e000'e000'e000'e000'e000'e000'e000'e000'x001'
x001'g000'e000'e000'e000'e000'e000'e000'e000'e000'e000'e000'e000'e000'e000'e000'e000'e000'e000'x001'
x001'g000'e000'e000'e000'e000'e000'e000'e000'e000'e000'e000'e000'e000'e000'e000'e000'e000'e000'x001'
x001'g000'e000'e000'e000'e000'e000'e000'e000'e000'e000'e000'e000'e000'e000'e000'e000'e000'e000'x001'
x001'x001'x001'x001'x001'x001'x001'x001'x001'x001'x001'x001'x001'x001'x001'x001'x001'x001'x001'x001'
